4 1 2 3 0 1 2 3 4 0 1 2 3 4 0 1 2 3 4 1
1 3 4 0 2 3 4 0 1 2 3 4 0 1 2 3 4 0 1 2
2 4 -1 -1 -1 -1 -1 -1 -1 -1 -1 -1 -1 -1 -1 -1 -1 -1 2 3
3 0 -1 0 1 2 3 4 0 1 2 3 4 0 1 2 3 -1 3 4
0 1 -1 1 2 3 4 0 1 2 3 4 0 1 2 3 4 -1 4 0
1 2 -1 2 3 4 0 1 2 3 4 0 1 2 3 4 0 -1 0 1
2 3 -1 -1 -1 -1 -1 -1 -1 -1 -1 -1 -1 -1 -1 -1 -1 -1 1 2
3 4 -1 3 4 0 1 2 3 4 0 1 2 3 4 0 1 -1 2 3
4 0 -1 4 0 1 2 3 4 0 1 2 3 4 0 1 2 -1 3 4
0 1 -1 0 1 2 3 4 0 1 2 3 4 0 1 2 3 -1 4 0
1 2 -1 -1 -1 -1 -1 -1 -1 -1 -1 -1 -1 -1 -1 -1 -1 -1 0 1
2 3 -1 3 4 0 1 2 3 4 0 1 2 3 4 0 1 -1 1 2
3 4 -1 4 0 1 2 3 4 0 1 2 3 4 0 1 2 -1 2 3
4 0 -1 0 1 2 3 4 0 1 2 3 4 0 1 2 3 -1 3 4
0 1 -1 -1 -1 -1 -1 -1 -1 -1 -1 -1 -1 -1 -1 -1 -1 -1 4 0
1 2 -1 2 3 4 0 1 2 3 4 0 1 2 3 4 0 -1 0 1
2 3 -1 3 4 0 1 2 3 4 0 1 2 3 4 0 1 -1 1 2
3 4 -1 4 0 1 2 3 4 0 1 2 3 4 0 1 2 -1 2 3
4 0 -1 0 1 2 3 4 0 1 2 3 4 0 1 2 3 -1 3 4
0 1 2 3 4 0 1 2 3 4 0 1 2 3 4 0 1 2 3 4
