101011001
011001101
110100110
001110011
100110100
010011011
111001001
000110110
101101001
011100110
110010101
001011010
100010111
010101100
111100011
000011100
101001110
011010001
110111000
001100101
100101011
010001101
111010110
000101001
101110100
011111010
110000111
001001100
100001011
010110101
111111000
000000111
101000101
011011010
110101101
001110010
100111011
010000101
111000010
000111101
101100110
011101001
110011100
001010011
100011010
010100101
111101110
000010001
101011100
011000011
110110100
001101011
100100110
010010001
111011100
000100011
101111010
011110101
110001011
001000101
100001110
010110001
111111100
000000011
101000010
011011101
110101010
001110101
100111100